0003111111111111000
0000010000100001000
0000110001110000000
0001100001010011100
0001000001011110000
0111111001000010000
0000001001000011111
0000000002000000000